#########################################################################################
#..........#..............#.......................#.....................................#
#..#######.#..##########..#.###########..#######..#.##########..#######..#############..#
#..#.......#..#........#..#...........#..#.....#..#..........#..#.....#..#...........#..#
#..#.#######..#.######.#..#.#########.#..#.###.#..#.########.#..#.###.#..#.#########.#..#
#..#.#........#.#....#.#..#.#.......#.#..#.#.#.#..#.#......#.#..#.#.#.#..#.#.......#.#..#
#..#.#..#######.#.##.#.#..#.#.#####.#.#..#.#.#.#..#.#.####.#.#..#.#.#.#..#.#.#####.#.#..#
#..#.#..#.......#.#..#.#..#.#.#P..#.#.#..#.#.#.#..#.#.#....#.#..#.#.#.#..#.#.#...#.#.#..#
#..#.#..#.#######.#..#.#..#.#.#.#.#.#.#..#.#.#.#..#.#.#.####.#..#.#.#.#..#.#.#.#.#.#.#..#
#..#.#..#.........#..#.#..#.#.#.E.#.#.#..#.#.#.#..#.#.#......#..#.#.#.#..#.#.#...#.#.#..#
#..#.#..###########..#.#..#.#.###.#.#.#..#.#.#.#..#.#.########..#.#.#.#..#.#.###.#.#.#..#
#..#.#...............#.#..#.#.....#.#.#..#.#.#.#..#.#...........#.#.#.#..#.#.....#.#.#..#
#..#.#################.#..#.#######.#.#..#.###.#..#.#############.#.#.#..#.#######.#.#..#
#..#...................#..#.........#.#..#.....#..#...............#.#.#..#.........#.#..#
#..#####################..###########.#..#######..#################.#.#..###########.#..#
#.....................................#.............................#.#..............#..#
#..#####################..###########.#..#######..#################.#.#..###########.#..#
#..#...................#..#.........#.#..#.....#..#...............#.#.#..#.........#.#..#
#..#.#################.#..#.#######.#.#..#.###.#..#.#############.#.#.#..#.#######.#.#..#
#..#.#...............#.#..#.#.....#.#.#..#.#.#.#..#.#...........#.#.#.#..#.#.....#.#.#..#
#..#.#..###########..#.#..#.#.###.#.#.#..#.#.#.#..#.#.########..#.#.#.#..#.#.###.#.#.#..#
#..#.#..#.........#..#.#..#.#.#...#.#.#..#.#.#.#..#.#.#......#..#.#.#.#..#.#.#...#.#.#..#
#..#.#..#.#######.#..#.#..#.#.#.#.#.#.#..#.#.#.#..#.#.#.####.#..#.#.#.#..#.#.#.#.#.#.#..#
#..#.#..#.......#.#..#.#..#.#.#...#.#.#..#.#.#.#..#.#.#....#.#..#.#.#.#..#.#.#...#.#.#..#
#..#.#..#######.#.##.#.#..#.#.#####.#.#..#.#.#.#..#.#.####.#.#..#.#.#.#..#.#.#####.#.#..#
#..#.#........#.#....#.#..#.#.......#.#..#.#.#.#..#.#......#.#..#.#.#.#..#.#.......#.#..#
#..#.#######..#.######.#..#.#########.#..#.###.#..#.########.#..#.###.#..#.#########.#..#
#..#.......#..#........#..#...........#..#.....#..#..........#..#.....#..#...........#..#
#..#######.####.########.##############.#######.##############.#######.###############..#
#########################################################################################