.......@@@......................................................................
.......@@@......................................................................
.......@@@......................................................................
.......@@@......................................................................
.......@@@..........@@@@@@@@@@@@@@@@@@@@@@@@@@@@@@@@@@@@@@@@@@@@@@@@@@@@@@@@@@@@
.......@@@..........@@@@@@@@@@@@@@@@@@@@@@@@@@@@@@@@@@@@@@@@@@@@@@@@@@@@@@@@@@@@
.......@@@..........@@@@@@@@@@@@@@@@@@@@@@@@@@@@@@@@@@@@@@@@@@@@@@@@@@@@@@@@@@@@
.......@@@..........@@@.........................................................
.......@@@..........@@@.........................................................
.......@@@..........@@@.........................................................
.......@@@@@@@@@@@@@@@@.........................................................
.......@@@@@@@@@@@@@@@@.........................................................
.......@@@@@@@@@@@@@@@@.........................................................
................................................................................
................................................................................
................................................................................
................................................................................
................................................................................
................................................................................
................................................................................
................................................................................
................................................................................
................................................................................
................................................................................
................................................................................
................................................................................
................................................................................
................................................................................
................................................................................
................................................................................