XXXXXXXXXXXXXXXXXXXXXXXXXXXXXXXXXXXXXXXXXXXXXXXXXXXXXXXXXXXXXXXXXXXXXXXXXXXXXXXXXXXXXXXXXXXXXXXXXXXX
X..................................................................................................X
X..................................................................................................X
X..................................................................................................X
X..................................................................................................X
X..................................................................................................X
X..................................................................................................X
X..................................................................................................X
X..................................................................................................X
X..................................................................................................X
X..................................................................................................X
X..................................................................................................X
X..................................................................................................X
X..................................................................................................X
X..................................................................................................X
X..................................................................................................X
X..................................................................................................X
X..................................................................................................X
X..................................................................................................X
X..................................................................................................X
X..................................................................................................X
X..................................................................................................X
X..................................................................................................X
X..................................................................................................X
X..................................................................................................X
X..................................................................................................X
X..................................................................................................X
X..................................................................................................X
X..................................................................................................X
X..................................................................................................X
X..................................................................................................X
X..................................................................................................X
X..................................................................................................X
X..................................................................................................X
X..................................................................................................X
X..................................................................................................X
X..................................................................................................X
X..................................................................................................X
X..................................................................................................X
X..................................................................................................X
X..................................................................................................X
X..................................................................................................X
X..................................................................................................X
X..................................................................................................X
X..................................................................................................X
X..................................................................................................X
X..................................................................................................X
X..................................................................................................X
X.................................................................................................TX
XXXXXXXXXXXXXXXXXXXXXXXXXXXXXXXXXXXXXXXXXXXXXXXXXXXXXXXXXXXXXXXXXXXXXXXXXXXXXXXXXXXXXXXXXXXXXXXXXXXX